#########################
#A        #       #     #
# ####### # ##### # ### #
# #     # #     # #   # #
# # ### # ##### ####### #
# # #   #     #     #   #
# # # ####### ##### # ###
# # # #       #     #   #
### # # ##### # #########
#   # #     # #   #     #
# ### ##### # ### ##### #
#     #   # #     #     #
####### # ####### #######
#       #       #       B
#########################
