#############################################
#A                  #     #     #       #   #
##### # ##### ### ### ### ### ### ##### ### #
#     # #   # #     #     #     #   #   #   #
# ### ### # # ### # ##### ### ##### # ##### #
#   #     # #     #     #   #     # #     # #
##### ##### ##### ##### ##### ### ### ### ###
#     #       #     #   #     #   #   #   # #
# ########### ##### # ### ####### # # ### # #
#     #     #     #         #     # #   # # #
### ### ### ##### ####### ####### ##### # ###
#   #     # #       #   # #     #   #   #   #
# ####### # ##### # # ### ##### ### ### ### #
# #     # #     # # #         #     # #     #
### ### ####### # # ####### # ##### ### #####
#   #   #     # #       #   #     #   #     #
##### ##### ### ####### ### ### ####### ### #
#     #     #       #   #   #           #   #
# ##### ########### ### ##### # ### ### ### #
#       #           #       # #     #     B #
#############################################
