#########################
#   #       #         # #
# # ####### ####### # # #
# # #     #     #   # # #
# # # ### # ### # ### ###
#   #   # # #   #     # #
##### # ### ####### # # #
#     # #   #     # # # #
### ##### # # ### ##### #
#       # #   #     #   #
# ##### # ####### ### ###
#     #           # #   #
### ### ##### ####### ###
#   #   #         #     #
# ####### ##### ####### #
#       #     B #       #
##### ############# #####
A     #       #       # #
#########################
